{
  "maze": [
    ["#","#","#","#","#","#","#","#","#","#","#","#","#","#","#"],
    ["#","S"," ","T","#"," "," "," ","#"," "," "," "," "," ","#"],
    ["#","#","#"," ","#"," ","#","#","#","#","#"," ","#"," ","#"],
    ["#"," "," ","G","#","G"," ","G","#"," "," "," ","#","T","#"],
    ["#","#","#"," ","#"," ","#","#","#"," ","#","#","#"," ","#"],
    ["#"," "," "," ","#"," "," "," "," "," "," "," ","#"," ","#"],
    ["#"," ","#","#","#","#","#"," ","#"," ","#"," ","#"," ","#"],
    ["#"," ","#","G","#"," "," "," ","#","G","#"," ","#","G","#"],
    ["#"," ","#"," ","#","#","#","#","#"," ","#","#","#","#","#"],
    ["#","G"," "," "," "," "," "," "," "," "," ","G"," "," ","#"],
    ["#","#","#","#","#","#","#","#","#","#","#"," ","#","#","#"],
    ["#"," "," "," "," "," ","#"," "," "," ","#"," "," ","B","#"],
    ["#"," ","#","#","#"," ","#"," ","#","#","#","#","#"," ","#"],
    ["#"," ","#"," "," "," "," "," "," "," "," ","G"," ","E","#"],
    ["#","#","#","#","#","#","#","#","#","#","#","#","#","#","#"]
  ],
  "B": [100,150,200],
  "PlayerSkills": [[5,0],[10,2],[25,4]],
  "minRounds": 42,
  "CoinConsumption": 195,
  "bestSequence": [2,1,0,0,1,2,0,1,0,0,2,1,0,0,1,2,0,1,0,0,2,1,0,0,1,2,0,1,0,0,2,1,0,0,1,2,0,1,0,0,2,1]
}
